border_size=1
usage=map

Mm^Xm, Mm^Xm, Mm^Xm, Mm, Mm, Mm, Mm, Mm, Mm, Hh, Gll^Fmw, Mm^Fp, Mm, Mm, Mm, Hh, Mm, Mm, Mm^Xm, Mm^Xm, Mm^Xm, Mm^Xm, Mm^Xm, Mm^Xm, Mm^Xm, Mm^Xm, Mm, Mm, Mm, Mm, Mm, Mm, Re, Mm, Mm, Mm, Mm, Mm, Mm^Xm, Mm^Xm, Mm^Xm, Mm^Xm
Mm^Xm, Mm^Xm, Mm^Xm, Mm^Xm, Mm, Mm, Mm, Hh^Fmw, Hh^Fp, Gll^Em, Hh^Fp, Hh, Mm, Mm, Mm, Mm, Mm, Mm, Mm, Mm^Xm, Mm^Xm, Mm^Xm, Mm^Xm, Mm^Xm, Mm^Xm, Mm^Xm, Mm, Mm, Mm, Mm, Mm, Mm, Mm, Re, Mm, Mm, Mm, Mm, Mm, Mm^Xm, Mm^Xm, Mm^Xm
Mm^Xm, Mm^Xm, Mm^Xm, Mm, Mm, Mm, Mm, Hh^Fmw, Gll^Fp, Gll^Emf, Gll^Em, Hh^Fmw, Mm, Mm, Mm, Mm, Mm, Mm, Mm, Mm, Mm, Mm, Mm, Mm, Mm, Mm, Mm, Mm, Mm, Mm, Mm, Mm, Hh^Es, Re, Mm, Mm, Mm, Mm, Mm, Mm, Mm, Mm^Xm
Mm, Mm, Mm, Mm, Mm, Mm, Mm, Hh^Fmw, Hh, Gll^Fmw, Mm, Hh, Hh^Fmw, Mm, Mm, Mm, Mm, Mm, Mm, Mm, Mm, Mm, Mm, Mm, Hh^Vhh, Mm, Mm, Mm, Mm, Mm, Mm, Hh, Mm, Re, Re, Hh^Es, Mm, Hh^Es, Mm, Mm, Mm, Mm^Xm
Mm, Mm^Xm, Mm, Mm, Mm, Mm, Mm, Mm, Hh^Fmw, Hh^Fp, Mm, Hh^Fdw, Mm, Mm, Mm, Mm, Mm, Mm, Mm, Mm, Mm, Mm, Mm, Re^Gvs, Re^Gvs, Mm, Hh^Es, Mm, Mm, Mm, Mm, Mm, Mm, Mm, Re, Mm, Mm, Mm, Mm, Mm, Mm, Mm
Hh, Mm, Mm, Mm, Mm, Hh, Mm^Xm, Mm, Mm, Mm, Hh, Hh^Fdw, Mm, Mm, Hh^Fdw, Mm, Mm, Mm, Mm, Mm, Mm, Hh^Fdw, Hh^Es, Re^Gvs, Re^Gvs, Hh^Fdw, Hh^Es, Mm, Mm, Mm, Mm, Mm, Mm, Mm, Mm, Re, Re, Mm, Mm, Mm, Mm, Mm
Hh, Mm, Mm, Mm, Mm, Mm, Mm, Mm, Hh^Fmw, Mm, Hh^Es, Mm, Mm, Mm, Hh^Fmw, Mm, Mm, Mm, Hh^Vc, Mm, Mm, Hh, Mm, Hh^Es, Re, Mm, Mm, Hh^Fdw, Mm, Mm, Hh^Fmw, Mm, Mm, Mm, Mm, Mm, Re, Mm, Mm, Mm, Ww, Ww
Hh, Hh, Mm, Mm^Xm, Mm, Mm^Xm, Mm^Xm, Mm, Hh^Fmw, Mm, Hh^Es, Mm, Mm, Hh^Fdw, Hh^Es, Mm, Mm, Mm, Hh^Fdw, Hh, Re^Gvs, Mm, Hh^Fdw, Gs, Mm, Mm, Mm, Hh, Mm, Mm, Hh^Fdw, Mm, Mm, Mm, Re, Mm, Re, Mm, Ww, Ww, Mm, Mm
Mm, Mm, Mm, Mm, Mm, Mm, Mm, Mm, Mm, Hh, Mm, Hh, Hh, Hh, Mm, Hh^Es, Hh, Mm, Hh, Re^Gvs, Re^Gvs, Mm, Hh^Fp, Gd, Mm, Hh^Fmw, Hh^Fmw, Hh^Fdw, Mm, Hh^Es, Hh, Mm, Hh^Fdw, Re, Mm, Re, Mm, Hh, Ww, Mm, Mm, Mm
Re, Mm, Re, Mm, Hh, Mm, Mm, Mm, Mm, Mm, Hh^Es, Hh^Fdw, Hh, Hh^Es, Gd, Mm, Hh^Fmw, Mm, Hh, Re^Gvs, Gd, Hh^Fdw, Hh^Fp, Gd, Gs, Hh^Fp, Mm, Mm, Mm, Hh, Gs, Mm, Hh, Re, Mm, Mm, Hh, Hh^Es, Ww, Mm, Mm, Mm
Mm, Re, Mm, Re, Re, Mm, Hh, Mm, Mm, Mm, Hh^Es, Gd, Gd, Hh, Gs^Es, Hh, Gs, Hh^Fdw, Gd, Hh, Gs, Gs, Hh, Hh^Fmw, Gs, Re, Re, Hh^Es, Hh, Gd, Gs, Hh^Es, Re, Re, Mm, Hh^Fdw, Ww, Ww, Hh^Fdw, Hh^Fp, Mm, Mm
Gll^Fp, Hh, Hh^Fmw, Mm, Re, Mm, Mm, Mm, Mm, Mm, Mm, Mm, Hh, Gs, Hh^Es, Gs, Hh, Gs, Gs, Hh, Hh, Hh, Gd, Hh, Hh, Gg, Re, Hh, Hh, Gs, Hh^Es, Hh, Re, Mm, Ww, Ww, Mm, Hh, Mm, Hh^Fp, Mm, Mm
Hh^Fmw, Gll^Fp, Hh^Fdw, Mm, Hh, Re, Re, Mm, Re^Gvs, Hh^Vh, Hh, Hh^Es, Mm, Hh, Hh, Hh, Gs, Gs, Gd, Hh^Es, Hh^Fdw, Hh, Hh, Re^Gvs, Re^Gvs, Gs, Hh, Re, Re, Gs, Hh, Re, Hh, Mm, Ww, Hh, Mm, Mm, Mm, Mm, Mm, Mm
Mm, Gll^Em, Gll^Emf, Gll^Em, Hh, Mm, Mm, Re, Re^Gvs, Re^Gvs, Hh^Fdw, Mm, Re, Hh^Fmw, Hh, Hh^Es, Hh^Es, Gs, Gd, Hh^Es, Gd, Hh, Hh, Re^Gvs, Gs, Hh, Re, Re, Hh, Re, Re, Re, Hh, Hh, Ww, Hh, Mm, Mm, Hh, Mm, Mm, Mm
Mm, Mm, Mm, Hh^Fdw, Mm, Gs, Gd, Re, Re, Re^Gvs, Re, Re, Mm, Re, Hh, Hh, Gs, Hh^Es, Hh, Gs, Gs, Hh, Gg, Gs, Gs, Gg, Re, Mm, Mm, Hh, Hh, Mm, Hh, Mm, Ww, Mm, Mm, Hh^Fp, Mm, Mm, Mm, Mm
Mm, Mm, Mm, Mm, Mm, Hh^Fdw, Hh, Gd, Gs, Re, Hh, Hh^Fmw, Hh, Re, Rp, Hh^Fdw, Gg, Hh, Gs^Fp, Gs^Fp, Ce, Gs, Gs, Ce, Ce, Gg^Fp, Gg^Fp, Re, Mm, Mm, Mm, Hh^Fp, Ww, Ww, Hh^Fp, Hh^Fp, Hh, Hh, Mm, Mm, Mm, Mm
Mm, Mm, Mm, Mm, Mm, Hh^Fmw, Mm, Hh, Gll^Em, Hh^Fdw, Hh^Fdw, Hh, Gll^Em, Hh, Gs^Fdw, Rp, Rp, Gs, Ce, Ce, Re^Vct, Ce, Gg, Gg, Gs, Ce, Re, Re, Hh, Hh^Fdw, Hh^Fmw, Hh^Fmw, Ww, Gg^Efm, Gg, Gg^Em, Hh^Fp, Mm, Mm, Mm, Mm, Mm
Hh^Fmw, Hh^Fp, Hh^Fmw, Mm, Mm, Mm, Mm, Hh, Hh^Fp, Gll^Fmw, Gll^Fmw, Hh, Gll^Fdw, Gll^Emf, Gs^Fmw, Hh, Rp, Gs, Rp, Re^Vct, Gs, Gg, 2 Gg, Re^Vct, Rp, Rp, Wwf, Hh^Fp, Ww, Ww, Ww, Ww, Hh, Gg^Fmw, Mm, Hh, Mm, Mm, Mm, Mm, Hh^Fmf, Hh^Fmf
Hh^Fdw, Hh^Fmw, Mm, Mm, Mm, Mm, Mm, Hh^Fmw, Mm, Hh^Fdw, Hh^Fmw, Gll^Fmw, Hh^Fmw, Hh^Fmw, Gg^Fp, Gg^Efm, Gg, Rp, Ce, Rp, Rp, Re^Vct, Rp, Rp, Re^Vct, Ce, Ww, Ww, Gll^Fmw, Gll^Fdw, Gll^Fmw, Hh^Fdw, Hh, Hh^Fdw, Mm, Mm, Hh, Hh^Fdw, Mm, Mm, Hh^Fmf, Gg^Fdf
Mm, Hh, Hh, Hh^Vhh, Hh, Hh^Es, Hh, Mm, Hh, Hh^Fdw, Hh, Hh^Fdw, Gll^Em, Hh^Fdw, Hh^Fp, Hh^Fp, Hh, Gs, Ce, Re^Vct, Rp, Rp, Ce, Re^Vct, Ce, Ce, Ww, Hh, Hh^Fp, Hh^Fmw, Hh^Fdw, Mm, Mm, Mm, Mm, Mm, Mm, Hh^Fmw, Hh^Fp, Hh^Fmf, Hh^Fdf, Gll^Fdf
Mm, Hh^Fdw, Hh, Re^Gvs, Re^Gvs, Hh, Hh, Hh, Gd^Wm, Hh^Es, Hh, Hh^Fmw, Hh, Hh, Hh^Fmw, Gg^Efm, Gg^Efm, Gg, Gg, Ce, Rp, Ce, Gs, Ce, Gs, Ww, Hh, Hh^Fmw, Gs, Hh^Fp, Hh^Fmw, Gll^Em, Gll^Em, Hh^Fmf, Hh^Fmf, Hh^Fdf, Hh^Fdf, Gg^Fmf, Gg, Hh^Fmf, Gll, Gll
Hh, Mm, Mm, Hh, Hh, Re^Gvs, Hh, Hh^Fdw, Gd, Hh, Mm, Mm, Mm, Mm, Mm, Hh, Hh, Gg, Hh, Rp, Gg, Gs, Gs^Fmw, Gs, Gs^Fp, Ww, Ww, Ww, Ww, Gs^Fp, Gs, Hh^Fp, Gg^Fp, Hh, Gg^Fp, Hh^Fdf, Gll^Emf, Gll^Fp, Hh, Gg, Gll^Fmf, Gll^Fp
Hh^Fmw, Hh^Es, Hh, Hh^Es, Gs, Re, Gs, Gs, Gs, Hh, Hh^Fdw, Mm, Hh^Es, Mm, Hh^Es, Hh^Es, Mm, Hh^Fdw, Hh^Es, Rp, Gg, Gs^Fp, Gll^Fmw, Gs^Fmw, Hh^Fp, Gs^Fmw, Gs^Fdw, Gs, Ww, Gs, Gs, Gg^Fmw, Hh, Gg, Hh^Fmw, Gg^Fmf, Gll^Em, Gll^Em, Hh, Hh, Hh^Fdf, Gll^Fdf
Mm, Hh^Fdw, Mm, Hh, Hh, Gs, Hh, Gs, Gs, Hh, Hh^Es, Mm, Hh, Mm, Hh, Mm, Mm, Mm, Hh^Es, Rp, Rp, Gs, Gs, Gll^Fp, Hh^Fp, Hh, Ww, Ww, Re, Gd, Hh, Gs, Hh, Hh^Fdw, Hh, Hh, Mm, Hh, Hh, Hh, Mm, Hh^Fdf
Mm, Mm, Mm, Mm, Hh, Hh, Mm, Hh, Hh, Gd, Gd, Hh, Hh, Hh, Hh, Mm, Hh^Fdw, Hh^Fmw, Hh^Fdw, Hh^Es, Hh, Rp, Gs^Fmw, Hh^Fp, Hh^Es, Hh^Es, Ww, Gs, Re^Es, Re^Edb, Re, Hh, Mm, Hh, Hh, Hh, Mm, Hh, Hh, Hh, Mm, Mm
Mm, Mm, Mm, Mm, Mm, Hh^Fmw, Mm, Mm, Hh, Hh, Gs, Re^Gvs, Re^Gvs, Re^Gvs, Hh^Es, Hh, Rp, Rp, Rp, Rp, Rp, Rp, Gs, Hh, Hh^Fp, Ww, Dd^Es, Gd, Gd, Rd^Edp, Rd^Edb, Md, Mm, Hh^Fdw, Mm, Hh^Fdw, Mm, Mm, Hh, Mm, Mm, Mm
Mm, Mm, Hh^Fp, Mm, Hh^Fp, Mm, Hh^Fdw, Mm, Hh, Hh^Fdw, Hh, Hh, Hh, Re^Gvs, Gs, Rp, Gg, Gg, Gs^Fmw, Gs, Gs^Fmw, Gs, Gg, Gg^Fdw, Ww, Ww, Dd^Edpp, Gd, Hhd^Edp, Rd, Md, Md, Mm, Hh, Hh, Mm, Mm, Mm, Mm, Mm, Mm, Mm
Mm, Mm, Mm, Hh^Fp, Hh, Hh^Fdw, Hh^Fdw, Gll^Fmw, Gll^Fdw, Gs, Hh, Gs, Hh, Gd, Gs, Rp, Gg, Hh^Fp, Gg^Fmw, Hh, Hh, Gs^Fmw, Gs, Gg^Efm, Ww, Dd, Gd, Gd, Hhd, Md, Md, Md, Mm, Mm, Mm, Mm, Mm, Mm, Mm, Mm, Mm^Xm, Mm^Xm
Mm, Hh^Fp, Hh^Fmw, Hh^Fmw, Hh, Hh^Fmw, Gll^Fp, Hh, Gll^Em, Gll, Gs, Gs, Gs, Gs, Rp, Rp, Gs^Fmw, Hh, Gg^Efm, Gg^Efm, Hh^Fmw, Gll^Em, Hh, Gg^Fmw, Ww, Dd, Gs, Gs^Es, Hhd^Edp, Md, Hhd, Hh, Hh, Mm, Mm, Mm, Mm, Mm, Mm^Xm, Mm, Mm^Xm, Mm
Hh, Hh, Gll^Fp, Gll^Em, Gll^Fmw, Gll^Emf, Gll^Em, Hh, Hh, Hh^Fdw, Hh, Gg, Rp, Rp, Hh^Fmw, Gll^Fdw, Hh, Hh, Mm, Hh^Fp, Hh^Es, Hh^Es, Mm, Hh^Fp, Ww, Dd, Hhd^Es, Gs, Hhd, Hhd^Edp, Hhd, Mm, Mm, Mm, Mm, Mm, Mm, Mm^Xm, Mm^Xm, Mm^Xm, Mm^Xm, Mm^Xm
Hh, Hh^Fmw, Hh^Fdw, Hh^Fmw, Hh^Fdw, Hh, Hh^Fdw, Gll, Gll^Fmw, Gll, Hh^Fmw, Gg, Rp, Hh, Hh, Hh^Fp, Mm, Hh^Fdw, Mm, Mm, Mm, Mm, Hh^Fdw, Hh^Es, Hh, Ww, Ww, Hhd^Edp, Hhd, Hhd^Edb, Hhd^Edp, Mm, Mm, Mm, Mm, Mm, Mm, Mm, Mm^Xm, Mm^Xm, Mm^Xm, Mm^Xm
Mm, Mm, Mm, Mm, Mm, Hh^Fdw, Hh^Fp, Gll^Fmw, Hh^Fmw, Hh^Fp, Hh, Gll^Fdw, Rp, Hh^Fdw, Hh, Mm, Hh, Mm, Mm, Mm, Mm, Mm, Hh, Gs, Gd, Dd, Ww, Hhd^Edp, Gll^Em, Hhd, Mm, Mm, Hh, Hh, Mm, Mm, Hh, Mm, Mm, Mm^Xm, Mm^Xm, Mm^Xm
Mm, Mm, Mm, Mm, Hh^Fmf, Hh^Fmw, Gll^Em, Gll^Fp, Gll^Em, Gll, Gll^Fp, Gll^Fmw, Rp, Hh, Gll^Fdw, Hh^Fdw, Gll^Fp, Hh^Fmw, Mm, Mm, Hh^Es, Hh, Gs, Gs, Ww, Dd, Ww, Gs, Gll^Em, Hh, Mm, Mm, Mm, Mm, Mm, Mm, Mm, Mm, Mm, Mm, Mm^Xm, Mm^Xm
Mm, Mm, Mm, Hh^Fp, Hh^Fdf, Hh^Fp, Rp, Rp, Rp, Rp, Rp, 1 Rp, Gll^Em, Gll^Fmw, Gll^Fmf, Hh, Gll^Fmf, Hh^Fp, Hh^Fp, Hh, Hh, Gg^Efm, Ww, Ww, Gg^Efm, Ww, Gs, Gs, Hh, Mm, Mm, Mm, Mm, Mm, Hh, Mm, Hh^Dr, Mm, Mm, Mm, Mm, Mm^Xm
Hh^Fmf, Hh^Fp, Hh, Hh^Fmf, Hh^Fp, Gll^Fmf, Rp, Gll^Fmw, Gll^Fp, Hh, Hh^Fdw, Gs, Hh, Gll^Fp, Gll^Fmf, Gll^Em, Gll^Em, Hh^Fmf, Mm, Mm, Hh^Fp, Hh^Fmw, Ww, Gg^Efm, Gg, Gg, Gll^Em, Gll^Emf, Hh, Hh, Hh^Fdw, Mm, Mm, Mm, Hh, Hh^Fdw, Mm, Mm, Mm, Mm, Mm, Mm^Xm
Hh^Fp, Hh^Fp, Hh^Fp, Hh^Fmf, Gll^Em, Gll, Rp, Gll^Fp, Hh^Fp, Hh^Fp, Hh^Fp, Hh^Fp, Hh^Fmw, Gll^Fmw, Hh^Fp, Hh^Fdf, Hh, Hh^Fmf, Hh^Fdf, Hh^Fdf, Hh^Fp, Hh^Fp, Hh^Fp, Ww, Ww, Hh^Fmw, Hh^Fmw, Hh, Hh^Fdw, Hh, Mm, Hh, Hh, Hh^Fdw, Hh, Hh^Fdw, Mm, Mm, Mm, Mm, Mm, Mm
Gs^Fmf, Hh^Fmf, Hh, Gs^Fp, Rp, Rp, Gll^Fp, Gll, Gll^Em, Hh^Fmf, Mm, Hh^Fmf, Mm, Hh^Fdf, Hh^Fp, Mm, Hh^Fp, Hh^Fdf, Mm, Hh^Fdf, Hh^Fdf, Hh^Fmf, Hh^Fp, Hh^Fmw, Ww, Gll^Fp, Mm, Hh, Mm, Hh, Hh, Mm, Mm, Hh, Hh^Fdw, Hh, Hh^Es, Hh^Edb, Hh^Edb, Hh^Es, Mm, Mm
Rp, Gll^Fmf, Rp, Rp, Gll^Fp, Gll^Fp, Hh^Fmf, Hh^Fp, Gll^Em, Gll^Emf, Hh^Fmf, Mm, Mm, Hh, Mm, Mm, Mm, Mm, Mm, Hh^Fmw, Hh^Fp, Hh^Fmf, Ww, Ww, Gll^Fp, Gll^Fmf, Hh^Fp, Hh^Fmw, Hh^Fdw, Mm, Hh, Mm, Mm, Hh^Fdw, Mm, Hh^Es, Hh^Es, Hh^Edb, Hh^Vhhr, Mm, Mm, Mm
Gs, Rp, Gll, Gll^Em, Hh^Fmf, Hh^Fp, Hh, Hh, Mm, Hh^Fp, Hh^Fp, Mm, Hh^Fdf, Mm, Mm, Mm, Mm, Hh, Mm, Mm, Mm, Hh^Fmw, Ww, Hh^Fp, Hh^Fmf, Gll^Fdf, Hh^Fmw, Hh, Mm, Mm, Mm, Mm, Mm, Mm, Mm, Hh^Dr, Hh^Fdw, Mm, Mm, Mm, Mm, Mm
Gll^Fp, Gs^Fp, Gll^Fp, Hh, Hh^Fmf, Hh^Fmf, Hh^Fmf, Mm, Mm, Mm, Hh^Fmf, Hh^Fmf, Hh^Fdf, Mm, Mm, Mm, Hh^Fdf, Mm, Mm, Mm, Mm, Hh^Fdw, Ww, Hh^Fmf, Mm, Gll^Fmf, Mm, Hh, Mm, Mm, Mm, Mm, Mm, Mm, Mm, Mm, Mm, Mm, Mm, Mm^Xm, Mm^Xm, Mm^Xm
Hh, Hh, Hh, Hh^Fp, Hh^Fp, Hh^Fp, Hh, Mm, Mm, Hh^Fdf, Hh^Fdf, Hh^Fdf, Hh^Fmf, Mm, Hh, Mm, Hh, Hh^Fdf, Hh, Hh^Fdf, Ww, Ww, Hh^Fdw, Mm, Mm, Mm, Mm, Mm, Mm, Mm, Mm, Mm^Xm, Mm^Xm, Mm^Xm, Mm^Xm, Mm^Xm, Mm^Xm, Mm, Mm^Xm, Mm^Xm, Mm, Mm^Xm
