border_size=1
usage=map

Hh          , Hh          , Mm          , Mm          , Mm          , Mm          , Mm          , Mm          , Mm          , Mm          , Mm          , Mm          , Mm          , Mm          , Hh          , Hh          , Mm          , Mm          , Mm          , Mm          , Mm          , Mm          , Mm          , Mm          , Mm          , Mm          , Mm          , Mm          , Mm          , Mm          , Mm          , Mm          , Re          , Mm          , Mm          , Mm          , Mm          , Mm          , Mm          , Mm          , Mm          , Mm          
Hh          , Hh          , Hh          , Mm          , Mm          , Mm          , Mm          , Mm          , Mm          , Mm          , Mm          , Mm          , Mm          , Mm          , Hh          , Mm          , Mm          , Mm          , Mm          , Mm          , Mm          , Mm          , Mm          , Mm          , Mm          , Mm          , Mm          , Mm          , Mm          , Mm          , Mm          , Mm          , Mm          , Re          , Mm          , Mm          , Mm          , Mm          , Mm          , Mm          , Mm          , Mm          
Hh          , Hh          , Mm          , Hh          , Mm          , Hh          , Mm          , Mm          , Mm          , Hh          , Mm          , Hh          , Hh          , Mm          , Hh          , Mm          , Mm          , Mm          , Mm          , Mm          , Mm          , Mm          , Mm          , Mm          , Mm          , Mm          , Mm          , Mm          , Mm          , Mm          , Mm          , Mm          , Mm          , Re          , Mm          , Mm          , Mm          , Mm          , Mm          , Mm          , Mm          , Mm          
Mm          , Hh          , Mm          , Hh          , Hh          , Mm          , Mm          , Mm          , Hh          , Hh          , Mm          , Hh          , Hh          , Mm          , Mm          , Mm          , Mm          , Mm          , Mm          , Mm          , Hh          , Mm          , Hh          , Mm          , Mm          , Mm          , Mm          , Mm          , Mm          , Mm          , Mm          , Mm          , Mm          , Re          , Re          , Mm          , Mm          , Mm          , Mm          , Mm          , Mm          , Mm          
Mm          , Mm          , Mm          , Hh          , Hh          , Mm          , Hh          , Hh          , Hh          , Hh          , Mm          , Mm          , Hh          , Hh          , Mm          , Mm          , Mm^Xm       , Mm          , Mm          , Hh          , Hh          , Hh          , Mm          , Mm          , Mm          , Mm          , Mm          , Mm          , Mm          , Mm          , Mm          , Mm          , Mm          , Mm          , Re          , Mm          , Mm          , Mm          , Mm          , Mm          , Mm          , Mm          
Mm          , Mm          , Hh          , Hh          , Hh          , Mm          , Hh          , Mm          , Mm          , Mm          , Hh          , Hh          , Mm          , Mm          , Hh          , Mm          , Mm          , Mm          , Mm          , Mm          , Mm          , Hh          , Hh          , Gg          , Mm          , Mm          , Hh          , Mm          , Mm          , Mm          , Mm          , Mm          , Mm          , Mm          , Mm          , Re          , Re          , Mm          , Mm          , Mm          , Mm          , Mm          
Mm          , Mm          , Mm          , Hh          , Mm          , Mm          , Hh          , Mm          , Hh          , Hh          , Hh          , Mm          , Mm          , Mm          , Hh          , Mm          , Mm          , Mm          , Hh          , Mm          , Mm          , Hh          , Mm          , Hh          , Hh          , Mm          , Mm          , Hh          , Mm          , Mm          , Hh          , Mm          , Mm          , Hh          , Mm          , Mm          , Re          , Mm          , Mm          , Mm          , Ww          , Ww          
Mm          , Mm          , Mm          , Mm          , Mm          , Hh          , Mm          , Mm          , Mm          , Hh          , Hh          , Mm          , Mm          , Hh          , Hh          , Mm          , Mm          , Mm          , Hh          , Hh          , Hh          , Mm          , Hh          , Hh          , Mm          , Mm          , Mm          , Hh          , Mm          , Mm          , Hh          , Hh          , Mm          , Mm          , Re          , Mm          , Re          , Mm          , Ww          , Ww          , Mm          , Mm          
Mm          , Mm          , Mm          , Mm          , Mm          , Mm          , Mm          , Mm          , Mm          , Hh          , Mm          , Hh          , Hh          , Hh          , Mm          , Hh          , Hh          , Mm          , Hh          , Gg          , Hh          , Mm          , Hh          , Gg          , Mm          , Hh          , Hh          , Hh          , Mm          , Hh          , Hh          , Mm          , Mm          , Re          , Mm          , Re          , Mm          , Mm          , Ww          , Mm          , Mm          , Mm          
Mm          , Mm          , Mm          , Mm          , Mm          , Mm^Xm       , Mm          , Mm          , Mm          , Mm          , Hh          , Hh          , Hh          , Hh          , Gg          , Mm          , Hh          , Mm          , Hh          , Gg          , Gg          , Hh          , Hh          , Hh          , Hh          , Hh          , Mm          , Mm          , Mm          , Hh          , Hh          , Mm          , Hh          , Re          , Mm          , Mm          , Mm          , Mm          , Ww          , Mm          , Mm          , Mm          
Hh          , Hh          , Hh          , Hh          , Hh          , Mm          , Mm          , Mm          , Mm          , Hh          , Hh          , Hh          , Hh          , Hh          , Hh          , Hh          , Gg          , Hh          , Hh          , Hh          , Gg          , Hh          , Hh          , Hh          , Hh          , Hh          , Hh          , Hh          , Mm          , Hh          , Hh          , Hh          , Re          , Re          , Mm          , Mm          , Ww          , Ww          , Mm          , Mm          , Mm          , Mm          
Hh          , Hh          , Hh          , Mm          , Hh          , Mm          , Mm          , Mm          , Mm          , Mm          , Mm          , Mm          , Hh          , Hh          , Hh          , Hh          , Hh          , Gg          , Gg          , Hh          , Hh          , Hh          , Gg          , Hh          , Hh          , Hh          , Gg          , Gg          , Hh          , Hh          , Hh          , Hh          , Re          , Mm          , Ww          , Ww          , Mm          , Mm          , Mm          , Mm          , Mm          , Mm          
Hh          , Hh          , Hh          , Hh          , Hh          , Mm          , Mm          , Mm          , Hh          , Hh          , Mm          , Hh          , Hh          , Hh          , Hh          , Hh          , Gg          , Hh          , Gg          , Hh          , Hh          , Gg          , Hh          , Gg          , Gg          , Gg          , Hh          , Hh          , Re          , Hh          , Hh          , Re          , Mm          , Mm          , Ww          , Gg          , Mm          , Mm          , Mm          , Mm          , Mm          , Mm          
Mm          , Hh          , Hh          , Gg          , Hh          , Hh          , Mm          , Mm          , Hh          , Hh          , Mm          , Mm          , Hh          , Hh          , Hh          , Hh          , Hh          , Gg          , Gg          , Hh          , Gg          , Hh          , Hh          , Gg          , Gg          , Hh          , Re          , Re          , Hh          , Re          , Re          , Re          , Mm          , Mm          , Ww          , Hh          , Mm          , Mm          , Hh          , Mm          , Mm          , Mm          
Mm          , Mm          , Mm          , Hh          , Mm          , Gg          , Gg          , Hh          , Gg          , Hh          , Mm          , Mm          , Mm          , Hh          , Hh          , Hh          , Gg          , Hh          , Hh          , Gg          , Gg          , Hh          , Gg          , Gg          , Gg          , Re          , Re          , Mm          , Mm          , Hh          , Hh          , Mm          , Mm          , Mm          , Ww          , Mm          , Mm          , Hh          , Mm          , Mm          , Mm          , Mm          
Mm          , Mm          , Mm          , Mm          , Mm          , Hh          , Hh          , Gg          , Gg          , Hh          , Hh          , Hh          , Hh          , Hh          , Gg          , Hh          , Gg          , Hh          , Gg          , Gg          , Ce          , Gg          , Gg          , Ce          , Ce          , Gs^Fp       , Gs^Fp       , Re          , Mm          , Mm          , Mm          , Mm          , Ww          , Ww          , Hh^Fp       , Hh^Fp       , Hh          , Hh          , Hh          , Mm          , Mm          , Mm          
Mm          , Mm          , Mm          , Mm          , Mm          , Hh          , Mm          , Hh          , Gg          , Hh          , Hh          , Hh          , Gg          , Hh          , Gg          , Hh          , Hh          , Gg          , Ce          , Ce          , Re^Vct      , Ce          , Gg          , Gg          , Gg          , Ce          , Re          , Re          , Hh          , Hh          , Hh          , Hh          , Ww          , Gg          , Gg          , Gg          , Hh^Fp       , Mm          , Mm          , Mm          , Mm          , Mm          
Hh          , Hh          , Hh          , Mm          , Mm          , Mm          , Mm          , Hh          , Hh          , Gg          , Gg          , Hh          , Gg          , Gg          , Gg          , Hh          , Gg          , Gg          , Gg          , Re^Vct      , Gg          , Gg          , Gg          , Re^Vct      , Rp          , Rp          , Wwf         , Hh          , Ww          , Ww          , Ww          , Ww          , Hh          , Gg          , Mm          , Mm          , Mm          , Mm          , Mm          , Mm          , Hh          , Hh          
Hh          , Hh          , Mm          , Mm          , Mm          , Mm          , Mm          , Hh          , Mm          , Hh          , Hh          , Gg          , Hh          , Hh          , Gg          , Gg          , Gg          , Gg          , Ce          , Gg          , Gg          , Re^Vct      , Rp          , Rp          , Re^Vct      , Ce          , Ww          , Ww          , Hh          , Hh          , Gg          , Hh          , Mm          , Hh          , Mm          , Mm          , Hh          , Hh          , Mm          , Mm          , Hh          , Gg          
Mm          , Hh          , Hh          , Hh          , Hh          , Hh          , Hh          , Mm          , Hh          , Hh          , Hh          , Hh          , Gg          , Hh          , Hh          , Hh          , Hh          , Gg          , Ce          , Re^Vct      , Rp          , Rp          , Ce          , Re^Vct      , Ce          , Ce          , Ww          , Hh          , Hh          , Hh          , Hh          , Mm          , Mm          , Mm          , Mm          , Mm          , Mm          , Hh          , Hh          , Hh          , Hh          , Gg          
Mm          , Mm          , Hh          , Hh          , Hh          , Hh          , Hh          , Hh          , Hh          , Hh          , Hh          , Hh          , Hh          , Hh          , Hh          , Gg          , Gg          , Gg          , Gg          , Ce          , Rp          , Ce          , Gg          , Ce          , Gg          , Ww          , Hh          , Hh          , Hh^Fp       , Hh          , Hh          , Gg          , Hh          , Hh          , Hh          , Mm          , Hh          , Gg          , Gg          , Hh          , Gg          , Gg          
Hh          , Mm          , Mm          , Hh          , Hh          , Hh          , Hh          , Hh          , Gg          , Hh          , Mm          , Mm          , Mm          , Mm          , Mm          , Hh          , Hh          , Gg          , Hh          , Rp          , Gg          , Gg          , Gs^Fp       , Gg          , Gs^Fp       , Ww          , Ww          , Ww          , Ww          , Hh^Fp       , Gg          , Hh          , Gg          , Hh          , Gg          , Hh          , Gg          , Gg          , Hh          , Gg          , Gg          , Gg          
Mm          , Hh          , Hh          , Hh          , Gg          , Hh          , Gg          , Hh          , Gg          , Hh          , Hh          , Mm          , Hh          , Mm          , Hh          , Mm          , Mm          , Hh          , Hh          , Rp          , Gg          , Gs^Fp       , Gs^Fp       , Gs^Fp       , Gs^Fp       , Gs^Fp       , Hh^Fp       , Gs^Fp       , Ww          , Gs^Fp       , Gg          , Gg          , Hh          , Gg          , Hh          , Gg          , Gg          , Gg          , Hh          , Hh          , Hh          , Gg          
Mm          , Mm          , Mm          , Hh          , Hh          , Gg          , Hh          , Gg          , Gg          , Hh          , Hh          , Mm          , Hh          , Mm          , Hh          , Mm          , Mm          , Mm          , Hh          , Rp          , Rp          , Gg          , Gg          , Gs^Fp       , Hh^Fp       , Gs^Fp       , Ww          , Ww          , Hh^Fp       , Gs^Fp       , Hh          , Gg          , Hh          , Hh          , Hh          , Mm          , Mm          , Hh          , Hh          , Hh          , Mm          , Hh          
Mm          , Mm          , Mm          , Mm          , Hh          , Hh          , Mm          , Hh          , Hh          , Gg          , Gg          , Hh          , Hh          , Hh          , Hh          , Mm          , Hh          , Hh          , Hh          , Hh          , Hh          , Rp          , Gs^Fp       , Hh^Fp       , Hh          , Hh^Fp       , Ww          , Hh^Fp       , Hh          , Hh          , Hh          , Hh          , Mm          , Hh          , Mm          , Hh          , Mm          , Hh          , Hh          , Hh          , Mm          , Mm          
Mm          , Mm          , Mm          , Mm          , Mm          , Hh          , Mm          , Mm          , Hh          , Hh          , Gg          , Gg          , Gg          , Gg          , Hh          , Hh          , Rp          , Rp          , Rp          , Rp          , Rp          , Rp          , Gg          , Hh          , Hh          , Ww          , Hh^Fp       , Hh          , Hh          , Hh          , Mm          , Mm          , Mm          , Hh          , Mm          , Mm          , Mm          , Mm          , Hh          , Mm          , Mm          , Mm          
Mm          , Mm          , Hh          , Mm          , Hh          , Mm          , Hh          , Mm          , Hh          , Hh          , Hh          , Hh          , Hh          , Gg          , Gg          , Rp          , Gg          , Gg          , Gs^Fp       , Gg          , Hh^Fp       , Gg          , Hh          , Hh          , Ww          , Ww          , Hh          , Hh          , Hh          , Hh          , Mm          , Mm          , Mm          , Hh          , Hh          , Mm          , Mm          , Mm          , Hh          , Hh          , Mm          , Mm          
Mm          , Mm          , Mm          , Hh          , Hh          , Hh          , Hh          , Gg          , Gg          , Gg          , Hh          , Gg          , Hh          , Gg          , Gg          , Rp          , Gg          , Hh^Fp       , Gg          , Hh          , Hh          , Gg          , Hh          , Hh          , Ww          , Hh          , Hh          , Hh          , Hh          , Mm          , Mm          , Mm          , Mm          , Mm          , Mm          , Mm          , Mm          , Hh          , Mm          , Hh          , Mm          , Mm          
Mm          , Hh          , Hh          , Hh          , Hh          , Hh          , Gg          , Hh          , Gg          , Gg          , Hh          , Gg          , Rp          , Gg          , Rp          , Rp          , Gg          , Hh          , Gg          , Hh          , Hh          , Gg          , Hh          , Hh          , Ww          , Hh          , Hh          , Hh          , Hh          , Mm          , Hh          , Hh          , Hh          , Hh          , Mm          , Mm          , Mm          , Mm          , Mm          , Hh          , Mm          , Mm          
Hh          , Mm          , Mm          , Hh          , Hh          , Hh          , Gg          , Hh          , Hh          , Hh          , Hh          , Rp          , Gg          , Rp          , Hh          , Hh          , Hh          , Hh          , Mm          , Hh          , Hh          , Hh          , Mm          , Hh          , Ww          , Hh          , Hh          , Hh          , Hh          , Hh          , Hh          , Mm          , Mm          , Hh          , Mm          , Mm          , Mm          , Mm          , Mm          , Mm          , Mm          , Mm          
Mm          , Hh          , Mm          , Hh          , Hh          , Hh          , Hh          , Gg          , Gg          , Gg          , Hh          , Rp          , Rp          , Gg          , Hh          , Hh          , Mm          , Hh          , Mm          , Mm          , Mm          , Mm          , Hh          , Hh          , Hh          , Ww          , Ww          , Hh          , Hh          , Hh          , Hh          , Mm          , Mm          , Mm          , Mm          , Mm          , Mm          , Mm          , Mm          , Mm          , Mm          , Hh          
Mm          , Mm          , Mm          , Mm          , Mm          , Hh          , Hh          , Hh          , Gg          , Hh          , Hh          , Gg          , Rp          , Hh          , Hh          , Mm          , Hh          , Mm          , Mm          , Mm          , Mm          , Mm          , Hh          , Hh          , Hh          , Gg          , Ww          , Hh          , Hh          , Mm          , Mm          , Hh          , Hh          , Hh          , Mm          , Mm          , Hh          , Mm          , Hh          , Mm          , Mm          , Mm          
Mm          , Mm          , Mm          , Mm          , Hh          , Hh          , Gs^Fp       , Hh          , Gg          , Gg          , Gg          , Gg          , Rp          , Gg          , Hh          , Hh          , Hh          , Hh          , Mm          , Mm          , Hh          , Hh          , Gg          , Hh          , Ww          , Gg          , Ww          , Hh          , Hh          , Hh          , Mm          , Mm          , Mm          , Mm          , Mm          , Mm          , Mm          , Mm          , Hh          , Mm          , Mm          , Mm          
Mm          , Mm          , Mm          , Hh          , Hh          , Hh^Fp       , Rp          , Rp          , Rp          , Rp          , Rp          , 1 Rp        , Hh          , Gg          , Hh          , Hh          , Hh          , Hh          , Hh          , Hh          , Hh          , Hh          , Ww          , Ww          , Hh          , Ww          , Hh          , Hh          , Hh          , Mm          , Mm          , Mm          , Mm          , Mm          , Mm          , Hh          , Hh          , Hh          , Mm          , Mm          , Mm          , Mm          
Hh          , Hh          , Hh          , Hh          , Hh^Fp       , Gs^Fp       , Rp          , Gg          , Gg          , Hh          , Hh          , Gg          , Hh          , Gg          , Hh          , Gg          , Hh          , Hh          , Mm          , Mm          , Hh^Fp       , Hh          , Ww          , Hh          , Hh          , Hh          , Hh          , Hh          , Hh          , Hh          , Hh          , Mm          , Hh          , Mm          , Hh          , Hh          , Hh          , Mm          , Mm          , Mm          , Hh          , Hh          
Hh^Fp       , Hh          , Hh^Fp       , Hh          , Gs^Fp       , Gs^Fp       , Rp          , Gs^Fp       , Hh          , Hh          , Hh          , Hh          , Hh          , Hh          , Hh          , Hh          , Hh          , Hh          , Hh          , Hh          , Hh          , Hh^Fp       , Hh^Fp       , Ww          , Ww          , Hh          , Hh          , Hh          , Hh          , Hh          , Mm          , Hh          , Hh          , Hh          , Hh          , Hh          , Hh          , Mm          , Mm          , Mm          , Hh          , Hh          
Gs^Fp       , Hh^Fp       , Hh          , Gs^Fp       , Rp          , Rp          , Gs^Fp       , Gs^Fp       , Gg          , Hh          , Mm          , Mm          , Mm          , Hh          , Mm          , Mm          , Hh          , Hh          , Mm          , Hh          , Hh^Fp       , Hh^Fp       , Hh^Fp       , Hh^Fp       , Ww          , Hh^Fp       , Mm          , Hh          , Mm          , Hh          , Hh          , Mm          , Mm          , Hh          , Hh          , Mm          , Mm          , Hh          , Hh          , Hh          , Mm          , Mm          
Rp          , Gs^Fp       , Rp          , Rp          , Gg          , Gs^Fp       , Hh          , Hh^Fp       , Gg          , Gg          , Hh          , Mm          , Mm          , Hh          , Mm          , Hh          , Hh          , Mm          , Mm          , Hh          , Hh^Fp       , Hh^Fp       , Ww          , Ww          , Mm          , Hh^Fp       , Hh          , Hh          , Hh          , Mm          , Hh          , Mm          , Mm          , Hh          , Mm          , Mm          , Hh          , Hh          , Hh          , Mm          , Mm          , Mm          
Gg          , Rp          , Gg          , Gg          , Hh          , Hh^Fp       , Hh          , Hh          , Mm          , Hh          , Hh          , Mm          , Mm          , Mm          , Hh          , Mm          , Hh          , Hh          , Mm          , Mm          , Mm          , Hh          , Ww          , Hh^Fp       , Hh          , Mm          , Mm          , Mm          , Mm          , Mm          , Mm          , Mm          , Mm          , Mm          , Mm          , Mm          , Hh          , Mm          , Mm          , Hh          , Mm          , Mm          
Gg          , Gg          , Gg          , Hh          , Hh          , Hh          , Hh          , Mm          , Mm          , Mm          , Hh          , Hh          , Hh          , Mm          , Hh          , Hh          , Hh          , Mm          , Mm          , Mm          , Mm          , Hh          , Ww          , Hh          , Mm          , Mm          , Mm          , Mm          , Mm          , Mm          , Mm          , Mm          , Mm          , Mm          , Mm          , Mm          , Mm          , Mm          , Mm          , Mm          , Mm          , Mm          
Hh          , Hh          , Hh          , Hh          , Hh          , Hh          , Hh          , Mm          , Mm          , Hh          , Hh          , Hh          , Hh          , Mm          , Hh          , Hh          , Hh          , Hh          , Hh          , Hh          , Ww          , Ww          , Hh          , Mm          , Mm          , Mm          , Mm          , Mm          , Mm          , Mm          , Mm          , Mm          , Mm          , Mm          , Mm          , Mm          , Mm          , Mm          , Mm          , Mm          , Mm          , Mm          
